10222222222222122222222222221
14444444444444144444444444441
15111441111444144411114411151
14222442222444144422224422241
14444444444444244444444444441
14444444444444444444444444441
14222444144444444444144422241
14444444100222122200144444441
14444444144444144444144444441
22222144144444144444144122222
00000144122444244422144100000
00000144140000000004144100000
00000144140000r00004144100000
22222244240012321004244222222
00000044440010001004444000000
0000004444001pby1004444000000
22222144140022222004144122222
00000144140000500004144100000
00000144144444444444144100000
00000144144422122444144100000
12222244244444144444244222221
14444444444444144444444444441
14422144222444244422244122441
14444144444444P44444444144441
14444144144422122444144144441
15444244144444144444144244451
12244444144444144444144444221
14442222222244244222222224441
14444444444444444444444444441
20222222222222222222222222222


0 blank
1 wall
2 wall with _
3 gate            (only one)
P pacman          (only one)
rpby ghosts       (only four)
4 ball
5 power ball
